10
P.-.-.-.-.-.-.-.-.-
-.C.-.-.-.-.-.-.-.-
-.-.P.-.-.-.-.P.-.-
-.-.-.-.-.-.-.-.-.-
-.-.-.-.-.P_G.-.-.-.-
-.-.-.P.-.-.-.-.-.-
-.-.-.-.-.-.P.-.-.-
-.-.-.-.-.-.C.-.-.-
-.-.-.-.-.-.-.-.-.-
-.W.-.-.-.-.-.-.-.-