10
-.-.-.-.W.-.-.-.-.-
-.-.P.-.-.-.P_G.-.-
-.-.-.-.-.-.-.-.-.-
-.-.-.P.-.-.-.-.-.-
-.-.W.-.-.-.-.H_P.-
-.-.-.-.-.-.-.-.-.-
P.-.-.-.P_GW.-.-.-.-
-.-.-.-.-.-.-.-.-.-
-.-.-.-.-.-.-.-.W.-
-.-.-.-.-.-.-.-.-.-
