10
P.-.-.-.-.W,W,C.-.-.-.-
-.C.-.-.-.-.-.-.-.-
-.-.P.-.-.-.-.P.-.-
-.-.-.-.-.-.-.-.-.-
-.-.-.-.-.-.-.-.-.-
-.-.-.-.-.-.-.-.-.-
-.-.P_G.-.-.-.-.-.-.-
-.-.-.-.-.-.P_G,C.-.-.-
-.-.-.-.-.-.-.-.-.-
-.W.-.-.-.-.-.-.-.-