10
-.-.-.-.W.-.-.-.-.-
-.-.P.-.-.-.P_G.-.-
-.-.-.-.-.-.-.-.-.-
-.-.-.P.-.-.-.-.-.-
-.-.-.-.-.-.-.H_P.-
-.-.-.-.-.-.-.-.-.-
P.-.-.-.P_G.-.-.-.-
-.-.-.-.-.-.-.-.-.-
-.-.-.-.-.-.-.-.W.-
-.-.-.-.-.-.-.-.-.-
