10
P.-.P.-.-.-.-.-.-.-
-.-.-.-.-.-.-.-.-.-
-.-.-.-.-.-.-.-.-.C
-.-.-.-.-.-.-.-.-.-
-.-.-.W,W,C.-.-.-.-.-.-
-.-.-.-.W,W,W.-.-.-.-.-
-.-.-.-.-.-.-.-.-.-
-.-.-.-.-.-.-.-.-.-
-.-.-.-.C.-.-.-.-.-
-.-.-.-.-.-.-.-.-.-