10
-.-.W,W,C.-.-.-.-.-.P.-
-.-.-.-.-.-.-.P.-.C
-.-.-.-.-.-.-.P.-.-
-.-.C.-.-.-.-.-.P.-
-.-.-.-.-.W.-.-.-.-
-.-.-.-.-.-.-.-.P.-
-.-.H_P.-.-.-.-.-.-.-
-.-.-.-.-.-.-.-.-.-
-.-.-.-.-.-.-.-.-.-
-.-.-.-.-.P_G.-.-.-.-