10
-.-.-.-.-.-.-.-.-.-
-.-.-.-.-.-.-.-.-.-
-.-.W.-.-.-.-.-.-.-
-.-.-.-.-.-.-.-.-.-
-.-.-.C.-.-.-.-.-.-
-.-.-.-.-.-.-.-.-.-
-.-.-.-.-.-.-.-.-.-
P.-.-.-.-.W.-.-.-.-
-.-.-.-.-.-.-.-.-.-
-.-.P.-.-.-.-.-.-.-