10
-.-.-.-.-.-.-.-.-.-
-.-.-.-.-.-.-.-.-.-
-.-.W.-.-.-.-.-.-.-
-.-.-.-.-.-.-.-.-.-
-.-.-.C.-.-.-.-.-.-
-.-.-.-.-.-.-.-.-.-
-.-.-.-.-.-.-.-.-.-
P_G.-.-.-.-.W.-.-.-.-
-.-.-.-.-.-.-.-.-.-
P_G.-.P_G.-.-.-.-.-.-.-